aceprs -> capers,crapes,parsec,pacers,recaps,scrape,spacer
acerst -> carets,crates,caster,caters,recast,reacts,traces
adelst -> lasted,salted,slated,staled,deltas,desalt
adeprs -> parsed,padres,rasped,spared,spread,drapes
aelpst -> palest,plates,pleats,pastel,petals,staple
aderrw -> redraw,reward,drawer,warred,warder
aeprss -> passer,parses,spares,sparse,spears
aerrst -> arrest,rarest,raster,raters,starer
aerstt -> stater,treats,taster,tetras,taters
belstu -> bluest,bluets,bustle,sublet,subtle
eilnst -> enlist,inlets,listen,silent,tinsel
eimrst -> merits,mister,remits,timers,miters
eiprst -> esprit,priest,ripest,sprite,stripe
elrstu -> ulster,result,rustle,sutler,luster
acders -> cadres,sacred,scared,cedars
acdert -> crated,carted,redact,traced
acenrt -> canter,nectar,recant,trance
acenst -> enacts,ascent,secant,stance
acorst -> actors,castor,costar,scrota
adeerr -> reared,reread,reader,dearer
adegnr -> gander,garden,ranged,danger
adeilr -> railed,relaid,redial,derail
adeprt -> prated,parted,petard,depart
aderrt -> retard,tarred,trader,darter
aderst -> stared,trades,treads,daters
aeelrs -> leaser,resale,reseal,sealer
aelmnt -> lament,mantel,mantle,mental
aelpry -> parley,pearly,player,replay
aelrst -> alerts,alters,salter,staler
aelrsv -> ravels,salver,slaver,velars
aelsst -> slates,stales,steals,tassel
aemrst -> master,stream,tamers,maters
aeprrs -> parers,parser,rapers,sparer
airstt -> artist,strait,strati,traits
beirsu -> bruise,buries,busier,rubies
berstu -> brutes,buster,rebuts,tubers
cdeors -> credos,coders,scored,decors
ceorst -> escort,corset,rectos,sector
deeirt -> reedit,retied,tiered,dieter
degins -> signed,singed,deigns,design
deilst -> idlest,listed,silted,tildes
deinnt -> indent,intend,tinned,dentin
deorst -> stored,strode,sorted,doters
deprsu -> prudes,pursed,dupers,drupes
eeilrv -> eviler,levier,revile,relive
eersst -> esters,resets,serest,steers
eerstt -> retest,setter,street,tester
efilrs -> filers,lifers,rifles,fliers
efirst -> rifest,refits,sifter,strife
eforst -> forest,foster,fortes,softer
eginrs -> reigns,resign,signer,singer
ehlost -> tholes,helots,hostel,hotels
eorrst -> resort,roster,retros,sorter
inopst -> pintos,points,piston,pitons
abdelm -> ambled,blamed,bedlam,lambed
abelmr -> ambler,blamer,marble,ramble
abelst -> ablest,bleats,stable,tables
abesst -> basest,basset,bastes,beasts
acehrs -> arches,search,chaser
acehst -> sachet,chaste,cheats
aceimn -> iceman,cinema,anemic
acellr -> caller,recall,cellar
acelpr -> carpel,placer,parcel
acelrt -> claret,cartel,rectal
acerrt -> crater,carter,tracer
acersv -> carves,cavers,craves
acginr -> arcing,caring,racing
achnst -> snatch,stanch,chants
addemn -> madden,damned,demand
adders -> adders,sadder,dreads
adeenr -> earned,endear,neared
adeest -> seated,sedate,teased
adefrt -> farted,rafted,dafter
adehrt -> thread,hatred,dearth
adeils -> ideals,ladies,sailed
adeilt -> dilate,tailed,detail
adeipr -> paired,repaid,diaper
adeknr -> ranked,darken,danker
adekst -> skated,staked,tasked
adelor -> ordeal,loader,reload
adelps -> lapsed,pleads,pedals
adenrw -> wander,warned,warden
adinrs -> nadirs,dinars,drains
aeelps -> elapse,asleep,please
aefrst -> afters,faster,strafe
aeglns -> angels,angles,gleans
aeglrs -> glares,lagers,larges
aegrrt -> garret,grater,garter
aehrss -> rashes,shares,shears
aehrst -> earths,haters,hearts
aehrsw -> hawser,rewash,washer
aeimnr -> airmen,marine,remain
aeinrv -> naiver,ravine,vainer
aeiprs -> aspire,praise,spirea
aekrst -> skater,streak,takers
aeksst -> skates,stakes,steaks
aelmny -> laymen,meanly,namely
aelpss -> lapses,passel,sepals
aelrsy -> layers,relays,slayer
aeprst -> prates,repast,tapers
aersst -> assert,asters,stares
aerstv -> averts,starve,vaster
aerstw -> rawest,waster,waters
agilns -> aligns,lasing,signal
aginrt -> gratin,rating,taring
agnors -> organs,groans,sarong
agorst -> argots,groats,gators
ailnps -> lapins,plains,spinal
alprty -> paltry,partly,raptly
bbelru -> burble,lubber,rubble
bdeinr -> inbred,binder,rebind
bdeirs -> brides,rebids,debris
bdeist -> bedsit,bidets,debits
begins -> begins,beings,binges
beirst -> bestir,biters,tribes
ccorsu -> occurs,crocus,succor
cdeers -> creeds,screed,ceders
cdeesu -> educes,seduce,deuces
cdekor -> corked,rocked,docker
cehins -> inches,niches,chines
ceinst -> insect,incest,nicest
ceiprs -> cripes,prices,precis
cenors -> crones,recons,censor
cerstu -> eructs,cruets,truces
ciopst -> optics,picots,topics
ddeelu -> eluded,delude,dueled
deeinv -> envied,endive,veined
deeirs -> eiders,reside,desire
deenrs -> resend,sender,denser
deerst -> rested,desert,deters
deflow -> fowled,flowed,wolfed
degilr -> gilder,glider,girdle
deglno -> golden,longed,dongle
degoru -> gourde,rouged,drogue
dehors -> horsed,hordes,shored
deikln -> kilned,kindle,linked
deinrs -> rinsed,snider,diners
deirst -> stride,direst,driest
deloop -> looped,pooled,poodle
deloos -> oodles,loosed,soloed
deopst -> posted,depots,despot
deorsw -> drowse,dowser,dowers
deortu -> routed,toured,detour
derstu -> rusted,rudest,duster
eefilr -> liefer,refile,relief
eelrsv -> elvers,levers,revels
eenrst -> enters,resent,tenser
eenrtu -> neuter,tenure,tureen
eeprst -> preset,pester,peters
eeprsu -> peruse,purees,rupees
eerssv -> serves,severs,verses
efilrt -> filter,lifter,trifle
efilst -> itself,fliest,stifle
efinst -> infest,finest,feints
eginst -> ingest,signet,tinges
egorsu -> grouse,rogues,rouges
ehikrs -> hikers,shriek,shrike
ehirtw -> writhe,wither,whiter
ehisst -> thesis,heists,shiest
ehnors -> honers,herons,nosher
ehrssu -> ushers,rhesus,rushes
eillvy -> evilly,lively,vilely
eilprs -> lisper,pliers,perils
eilrsv -> livers,silver,sliver
eilsst -> islets,stiles,sliest
einpru -> unripe,punier,purine
einrss -> rinses,resins,sirens
einrsu -> inures,insure,ursine
eiqrsu -> quires,squire,risque
eirsst -> resist,resits,sister
elmnos -> lemons,melons,solemn
elorsw -> lowers,rowels,slower
elostw -> owlets,lowest,towels
ennost -> sonnet,tenons,tonnes
enorss -> snores,senors,sensor
enorst -> tenors,tensor,toners
enorsw -> owners,resown,worsen
enosst -> onsets,stenos,stones
eoprst -> presto,poster,tropes
eorsst -> sorest,stores,tosser
eorstv -> strove,troves,voters
ersstu -> russet,surest,estrus
ghlosu -> ghouls,loughs,slough
opsstu -> spouts,stoups,tossup
aailmn -> animal,lamina,manila
aalrst -> altars,astral,tarsal
aanrtt -> rattan,tantra,tartan
abdegr -> barged,badger,garbed
abdekr -> barked,braked,debark
abders -> breads,beards,debars
abdors -> adsorb,broads,boards
abeert -> berate,beater,rebate
abekrs -> bakers,brakes,breaks
abelry -> barley,bleary,barely
aberst -> barest,breast,baster
aabdor -> abroad,aboard
aablst -> basalt,tablas
aabmnt -> bantam,batman
aacetv -> caveat,vacate
aacimn -> caiman,maniac
aaclrs -> rascal,scalar
aaclsu -> casual,causal
aadmrs -> madras,dramas
aaffir -> affair,raffia
aailrt -> atrial,lariat
aailsv -> avails,saliva
aaimnr -> airman,marina
aainpt -> patina,pinata
aalmnu -> alumna,manual
abbder -> barbed,dabber
abbeir -> babier,barbie
abbelr -> barbel,rabble
abcers -> braces,cabers
abcors -> cobras,carobs
abddel -> balded,bladed
abdees -> seabed,debase
abdeis -> abides,biased
abdelr -> blared,balder
abdeos -> abodes,adobes
abderv -> adverb,braved
abdilr -> bridal,ribald
abdirs -> braids,disbar
abeeln -> enable,baleen
abegls -> bagels,gables
abehrt -> bather,breath
abeill -> labile,liable
abeirs -> braise,rabies
abelms -> ambles,blames
abelnu -> unable,nebula
abelrs -> blares,balers
abelsy -> belays,basely
abeltt -> battle,tablet
abenry -> barney,nearby
abersu -> abuser,bursae
abersz -> brazes,zebras
abinrs -> bairns,brains
abinry -> binary,brainy
abmrsu -> umbras,rumbas
abnory -> barony,baryon
aborst -> aborts,tabors
abosst -> boasts,sabots
acceip -> ipecac,icecap
acdegr -> graced,cadger
acdehs -> cashed,chased
acdekl -> lacked,calked
acdeln -> candle,lanced
acdels -> scaled,decals
acdemp -> camped,decamp
acdeno -> canoed,deacon
acdenr -> craned,dancer
acdens -> ascend,dances
acdent -> canted,decant
acdepr -> carped,redcap
acderv -> carved,craved
acdesu -> caused,sauced
aceemr -> amerce,raceme
aceens -> encase,seance
aceeps -> escape,peaces
acehms -> schema,sachem
acehss -> cashes,chases
aceilr -> lacier,eclair
acekpr -> packer,repack
acekrt -> racket,tacker
acelms -> camels,mescal
acelns -> cleans,lances
acelov -> alcove,coeval
acelst -> cleats,castle
acemrs -> creams,scream
acenos -> oceans,canoes
acenrs -> caners,cranes
acenrv -> cavern,craven
acerrs -> carers,racers
acerss -> caress,scares
acersu -> causer,saucer
acertu -> acuter,curate
acessu -> causes,sauces
achrst -> starch,charts
acinot -> action,cation
acistt -> attics,static
aclopu -> copula,cupola
aclors -> carols,corals
aclpss -> clasps,scalps
aclrsw -> crawls,scrawl
acmors -> caroms,macros
acnnot -> cannot,canton
acnort -> cantor,carton
acosst -> ascots,coasts
acprss -> scarps,scraps
addegr -> graded,gadder
addehs -> dashed,shaded
addeil -> laddie,dialed
addeln -> landed,dandle
addelr -> ladder,larded
addels -> addles,saddle
addelw -> dawdle,waddle
addenr -> dander,darned
addens -> sanded,sadden
addert -> traded,darted
adeefr -> feared,deafer
adeegr -> agreed,geared
adeehr -> adhere,header
adeeln -> leaned,leaden
adeelp -> leaped,pealed
adeelr -> leader,dealer
adeels -> leased,sealed
adeemr -> reamed,remade
adeems -> seamed,edemas
adeers -> erased,seared
adeesv -> evades,deaves
adefil -> afield,failed
adeflo -> foaled,loafed
adefmr -> farmed,framed
adefry -> frayed,defray
adeggn -> ganged,nagged
adeggr -> ragged,dagger
adeggt -> gadget,tagged
adegln -> angled,dangle
adegos -> dagoes,dosage
adegot -> togaed,dotage
adegrr -> grader,regard
adehlt -> halted,lathed
adehms -> mashed,shamed
adehps -> phased,shaped
adehrs -> dasher,shared
adehss -> dashes,shades
adehst -> hasted,deaths
adeilm -> mailed,medial
adeiln -> nailed,denial
adeimn -> maiden,median
adeims -> amides,medias
adeiss -> asides,daises
adeisv -> advise,visaed
adekns -> kneads,snaked
adelms -> medals,damsel
adelpp -> lapped,dapple
adelsv -> salved,slaved
adelsy -> slayed,delays
ademno -> moaned,daemon
adenot -> atoned,donate
adenpp -> append,napped
adenpt -> panted,pedant
adenrr -> errand,darner
adenrs -> snared,sander
adenrt -> ardent,ranted
adeorr -> adorer,roared
adeors -> adores,soared
adeppr -> rapped,dapper
adeprr -> parred,draper
adepss -> passed,spades
adepst -> adepts,pasted
adertt -> ratted,tarted
adestt -> stated,tasted
adesty -> steady,stayed
adinor -> inroad,ordain
adinsv -> divans,viands
admnos -> nomads,damson
aeeglt -> eaglet,legate
aeegmn -> menage,manege
aeegnr -> enrage,genera
aeegrs -> agrees,grease
aeehrr -> hearer,rehear
aeehrt -> heater,reheat
aeehsv -> heaves,sheave
aeeirs -> aeries,easier
aeelpr -> leaper,repeal
aeelrv -> leaver,reveal
aeelss -> easels,leases
aeelst -> elates,teasel
aeemnr -> meaner,rename
aeemns -> enemas,seamen
aeenrr -> earner,nearer
aeenst -> senate,sateen
aeerst -> eaters,teaser
aefkrs -> fakers,freaks
aeflrs -> flares,falser
aefmrr -> farmer,framer
aefsst -> feasts,safest
aefsty -> fayest,safety
aeggnr -> grange,nagger
aeghnr -> hanger,rehang
aegiln -> genial,linage
aegimn -> enigma,gamine
aegimr -> gamier,mirage
aegims -> ageism,images
aeginr -> gainer,regain
aegirt -> gaiter,triage
aeglmn -> legman,mangle
aegmnr -> engram,manger
aegnrr -> garner,ranger
aegnrs -> angers,ranges
aegnrt -> argent,garnet
aegprs -> grapes,pagers
aegrst -> grates,greats
aegrsu -> argues,augers
aegrsz -> grazes,gazers
aegsst -> sagest,stages
aehhst -> heaths,sheath
aehlrt -> halter,lather
aehlss -> hassle,lashes
aehlst -> halest,lathes
aehlsw -> whales,wheals
aehmrs -> harems,masher
aehmss -> mashes,shames
aehnst -> thanes,hasten
aehnsv -> havens,shaven
aehors -> ashore,hoarse
aehprs -> phrase,seraph
aehpss -> phases,shapes
aehrrs -> rasher,sharer
aehrtt -> threat,hatter
aehrty -> earthy,hearty
aeilns -> aliens,saline
aeilss -> aisles,lassie
aeinns -> insane,sienna
aeinpt -> pantie,patine
aeinrs -> arisen,sarnie
aeinrt -> retain,retina
aeiprr -> rapier,repair
aeirrs -> raiser,sierra
aeirss -> arises,raises
aeirst -> satire,striae
aeirvw -> waiver,wavier
aeklnr -> lanker,rankle
aekmrr -> marker,remark
aekmrs -> makers,masker
aeknss -> snakes,sneaks
aekqsu -> quakes,squeak
aellru -> allure,laurel
aelmps -> maples,sample
aelmrs -> lamers,realms
aelmst -> lamest,metals
aelnps -> planes,panels
aelnpt -> planet,platen
aelnrt -> antler,rental
aelnru -> unreal,neural
aelntt -> latent,talent
aelppt -> applet,lappet
aelqsu -> equals,squeal
aelrtt -> latter,rattle
aelrtv -> travel,varlet
aelssv -> salves,slaves
aelstt -> lattes,latest
aelstv -> valets,vestal
aelstx -> exalts,laxest
aemnor -> moaner,enamor
aemnst -> stamen,mantes
aemppr -> mapper,pamper
aemrrw -> rewarm,warmer
aemrss -> masers,smears
aemssu -> amuses,assume
aemstt -> mattes,tamest
aemsty -> mateys,steamy
aenors -> reason,senora
aenprt -> entrap,parent
aenrrt -> errant,ranter
aensst -> assent,sanest
aenttu -> attune,tauten
aepprs -> papers,sapper
aeppry -> papery,prepay
aeprsy -> payers,repays
aepsst -> pastes,spates
aerrtt -> ratter,tarter
aerssw -> wrasse,swears
aerstx -> extras,taxers
aessss -> assess,sasses
aesstt -> states,tastes
aesstw -> sweats,wastes
aesttu -> astute,statue
aflstu -> faults,flatus
agginp -> gaping,paging
agilmn -> laming,malign
agimnr -> arming,margin
agimnt -> mating,taming
aginnw -> awning,waning
aginpr -> paring,raping
aginrs -> arsing,grains
aginst -> giants,sating
agnprs -> prangs,sprang
ahilps -> phials,palish
ahnstu -> haunts,sunhat
ahopst -> pathos,potash
ailnpt -> plaint,pliant
ailrst -> trails,trials
aimnst -> mantis,matins
aimprt -> armpit,impart
ainnot -> anoint,nation
ainrst -> strain,trains
ainsst -> saints,stains
ainstt -> taints,titans
ainsty -> sanity,satiny
aiopst -> patois,patios
aiorst -> ratios,satori
aiprst -> rapist,tapirs
airsst -> sitars,stairs
aissst -> assist,stasis
ajnstu -> jaunts,juntas
allost -> allots,atolls
allosw -> allows,sallow
almors -> molars,morals
almtuu -> umlaut,mutual
aloprt -> portal,patrol
alotuy -> outlay,layout
alrtty -> rattly,tartly
amnors -> manors,ransom
amorsy -> morays,mayors
anoprs -> aprons,parson
anoprt -> patron,tarpon
anruwy -> unwary,runway
aoprrt -> parrot,raptor
aorsst -> assort,roasts
aosstt -> stoats,toasts
aprsst -> sprats,straps
arssty -> satyrs,strays
bbdeir -> bribed,ribbed
bbdemo -> bombed,mobbed
bbderu -> rubbed,dubber
bbeirr -> briber,ribber
bbelpy -> pebbly,plebby
bcistu -> cubist,cubits
bddeir -> bidder,birded
bdeeil -> edible,belied
bdeglu -> bugled,bulged
bdegsu -> budges,debugs
bdeknu -> bunked,debunk
bdenru -> burned,burden
bdestu -> busted,debuts
beelps -> bleeps,plebes
beffru -> buffer,rebuff
befirs -> briefs,fibers
beglru -> bugler,burgle
beglsu -> bugles,bulges
begoor -> booger,goober
beilor -> boiler,reboil
beimrt -> timber,timbre
belmru -> lumber,rumble
belorw -> bowler,blower
belosu -> blouse,boules
belosw -> elbows,bowels
bemoss -> emboss,besoms
beorst -> sorbet,strobe
beorsw -> browse,bowers
beosss -> obsess,bosses
bgilnu -> bluing,lubing
bginor -> boring,robing
bhorst -> throbs,broths
biorst -> orbits,bistro
borstu -> robust,turbos
ccehil -> chicle,cliche
ccehio -> echoic,choice
cceilr -> cleric,circle
cciirt -> critic,citric
ccimos -> comics,cosmic
cddeei -> decide,deiced
cddeeu -> educed,deduce
cdeeer -> recede,decree
cdehko -> hocked,choked
cdeikr -> ricked,dicker
cdeilo -> coiled,docile
cdeirt -> credit,direct
cdelru -> curled,curdle
cdenos -> consed,second
cdipsu -> cupids,cuspid
cdnoor -> condor,cordon
ceehor -> cohere,reecho
ceehps -> speech,cheeps
ceeipr -> pierce,recipe
ceeips -> pieces,specie
ceelst -> elects,select
ceenrs -> screen,censer
ceenrt -> recent,center
ceeprs -> creeps,crepes
ceeptx -> expect,except
ceerss -> recess,screes
ceerst -> erects,secret
ceersu -> rescue,secure
cefhis -> fiches,chiefs
cefors -> fresco,forces
cehior -> heroic,coheir
cehist -> ethics,itches
cehsty -> scythe,chesty
ceiist -> iciest,cities
ceikln -> nickel,nickle
ceilrs -> relics,slicer
ceimru -> cerium,uremic
ceimsu -> miscue,cesium
ceinpr -> pincer,prince
ceirrs -> criers,ricers
ceirsu -> cruise,curies
ceistv -> evicts,civets
ceknor -> conker,reckon
cekoor -> cooker,recook
cekorr -> corker,rocker
cenoss -> conses,scones
ceopss -> copses,scopes
ceorrs -> corers,scorer
ceorsu -> course,source
ceorsw -> escrow,cowers
ceortv -> covert,vector
cerrsu -> curers,recurs
cerssu -> cruses,curses
cestuy -> cutesy,cuteys
cgimno -> coming,gnomic
chikst -> kitsch,shtick
chimrs -> smirch,chrism
cimprs -> crimps,scrimp
cinost -> tocsin,tonics
ciprss -> crisps,scrips
cirstu -> rustic,citrus
ckrstu -> struck,trucks
clmsuy -> clumsy,muscly
clostu -> clouts,locust
crstuy -> crusty,curtsy
dddeil -> lidded,diddle
ddeefn -> fended,defend
ddeein -> indeed,denied
ddeeit -> edited,dieted
ddeelm -> melded,meddle
ddeemo -> demoed,demode
ddeenp -> pended,depend
ddeent -> dented,tended
ddeenu -> endued,denude
ddefor -> fodder,forded
ddegil -> gilded,glided
ddegir -> girded,ridged
ddegnu -> nudged,dunged
ddeimn -> minded,midden
ddeios -> didoes,diodes
ddeiov -> devoid,voided
ddiors -> sordid,droids
deeefr -> feeder,reefed
deeelr -> leered,reeled
deeepr -> peered,deeper
deeers -> reseed,seeder
deeffr -> reffed,deffer
deegls -> ledges,sledge
deeilr -> lieder,relied
deeils -> elides,diesel
deeilv -> levied,veiled
deeinr -> reined,denier
deeins -> seined,denies
deeisv -> sieved,devise
deelpy -> deeply,yelped
deelrw -> lewder,welder
deemot -> emoted,demote
deempr -> permed,premed
deenrt -> rented,tender
deenst -> nested,tensed
deensu -> ensued,endues
deentt -> netted,tented
deeors -> erodes,redoes
deeotv -> devote,vetoed
deersv -> served,versed
deestt -> tested,detest
deestw -> stewed,tweeds
deffir -> riffed,differ
deffru -> ruffed,duffer
defgit -> fidget,gifted
defikn -> finked,knifed
definr -> finder,friend
deflno -> enfold,fondle
deflor -> folder,refold
defmor -> formed,deform
deggir -> rigged,digger
degglo -> logged,dogleg
deggru -> grudge,rugged
deginn -> ending,ginned
degirs -> ridges,dirges
degklu -> kludge,kluged
deglnu -> gulden,lunged
dehiss -> hissed,dishes
dehitw -> withed,whited
dehlru -> hurled,hurdle
dehoop -> hooped,poohed
deiins -> inside,indies
deiknr -> kinder,dinker
deillt -> lilted,tilled
deilmp -> limped,dimple
deilms -> misled,smiled
deilnt -> linted,delint
deilos -> oldies,soiled
deilps -> lisped,dispel
deilrs -> idlers,slider
deilss -> slides,sidles
deiltt -> tilted,titled
deimmr -> rimmed,dimmer
deimnr -> minder,remind
deimst -> misted,demist
deinop -> opined,ponied
deinos -> onside,noised
deinru -> inured,ruined
deinrw -> rewind,winder
deintu -> united,untied
deiopr -> period,dopier
deiort -> editor,rioted
deippr -> ripped,dipper
deiprs -> prides,spider
deirrs -> riders,driers
deirsv -> divers,drives
deisst -> desist,deists
deissu -> issued,disuse
deistu -> suited,duties
delmor -> molder,remold
delmos -> models,seldom
delmpu -> lumped,plumed
deloot -> looted,tooled
delors -> resold,solder
deloru -> loured,louder
delosw -> slowed,dowels
demoor -> moored,roomed
denors -> snored,drones
denorw -> downer,wonder
denosw -> endows,snowed
denrsu -> nursed,sunder
deoprs -> spored,dopers
deoprt -> ported,deport
deopsu -> pseudo,souped
deorru -> ordure,dourer
deorsu -> roused,soured
deossu -> soused,douses
dginos -> doings,dosing
dhlopu -> uphold,holdup
dhnosu -> unshod,hounds
dinpuw -> upwind,windup
dintuy -> untidy,nudity
dioprt -> torpid,tripod
dllory -> lordly,drolly
dnoors -> rondos,donors
dnortu -> untrod,rotund
eeelsv -> levees,sleeve
eeenrv -> evener,veneer
eeersv -> reeves,severe
eeflru -> ferule,refuel
eefrst -> freest,fester
eegimr -> regime,emigre
eegins -> genies,seeing
eegnrs -> genres,greens
eegrst -> egrets,greets
eehinr -> inhere,herein
eehlsv -> helves,shelve
eehort -> hereto,hetero
eehprs -> herpes,sphere
eehrsw -> hewers,wheres
eehsst -> theses,sheets
eeirvw -> review,viewer
eellrs -> resell,seller
eellrt -> retell,teller
eelmpt -> pelmet,temple
eelnss -> lenses,lessen
eelntt -> nettle,telnet
eelprs -> lepers,repels
eelsst -> sleets,steels
eelssv -> selves,vessel
eelsty -> sleety,steely
eemort -> meteor,remote
eemrst -> merest,meters
eennrt -> rennet,tenner
eenopr -> opener,reopen
eenrsw -> renews,resewn
eerrsv -> revers,server
eerssw -> resews,sewers
eesstt -> testes,tsetse
efginr -> finger,fringe
efgors -> forges,gofers
efillr -> filler,refill
efmorr -> former,reform
egginr -> ginger,nigger
egglru -> gurgle,lugger
eghhit -> eighth,height
eghins -> hinges,neighs
eghinw -> hewing,whinge
eghnru -> hunger,rehung
egilru -> uglier,gluier
eginor -> ignore,region
eginrr -> erring,ringer
eginss -> gneiss,singes
egiost -> egoist,stogie
egorrw -> grower,regrow
egprsu -> purges,spurge
egsstu -> gusset,guests
ehinrs -> shiner,shrine
ehiprs -> perish,reship
ehirsv -> shiver,shrive
ehirtt -> hitter,tither
ehistt -> theist,tithes
ehistw -> withes,whites
ehlosv -> hovels,shovel
ehlstu -> hustle,sleuth
ehnort -> throne,hornet
ehorss -> horses,shores
ehorst -> others,throes
ehorsw -> whores,shower
eijnor -> joiner,rejoin
eiklns -> likens,silken
eiklnw -> welkin,winkle
eikrss -> kisser,skiers
eikrst -> strike,trikes
eillnt -> lentil,lintel
eilmpr -> limper,prelim
eilmps -> impels,simple
eilmsy -> limeys,smiley
eilnos -> insole,lesion
eilnpu -> lineup,lupine
eilnsv -> livens,snivel
eilort -> loiter,toiler
eilrst -> tilers,liters
eilrvy -> livery,verily
eilstv -> livest,vilest
eimntu -> minuet,minute
eimors -> isomer,moires
eimprs -> primes,simper
eimpru -> impure,umpire
eimrss -> misers,remiss
einops -> opines,ponies
einors -> nosier,senior
einort -> orient,tonier
einprs -> ripens,sniper
einpss -> snipes,spines
einpst -> instep,spinet
einqsu -> quines,sequin
einrst -> insert,inters
einrtw -> twiner,winter
einsst -> insets,steins
einssw -> sinews,swines
einstu -> unites,unties
eiopss -> poises,posies
eipprs -> pipers,sipper
eipqsu -> equips,piques
eiprrs -> priers,sprier
eiprss -> pisser,spires
eipsss -> pisses,sepsis
eipsst -> pistes,spites
eirstv -> rivets,strive
eisstu -> suites,tissue
eisstx -> exists,sexist
ekorrw -> rework,worker
ekorst -> stoker,stroke
ellovy -> lovely,volley
elmnpu -> lumpen,plenum
elmors -> morels,morsel
elmost -> molest,motels
elmrty -> myrtle,termly
elnosv -> novels,sloven
eloort -> looter,retool
elorss -> lessor,losers
elorsv -> lovers,solver
eloruv -> velour,louver
elostu -> solute,tousle
elosvw -> wolves,vowels
elpssu -> pluses,pulses
emoors -> morose,romeos
emossu -> mousse,mouses
emostt -> motets,totems
enrrsu -> nurser,reruns
enrrtu -> return,turner
enrstu -> unrest,tuners
eoprrt -> porter,report
eoprss -> posers,spores
eoprtu -> pouter,troupe
eopssu -> opuses,spouse
eoqstu -> quotes,toques
eorrtt -> rotter,retort
eorssu -> rouses,serous
eorssv -> servos,versos
eorssw -> resows,sowers
eorstt -> otters,tortes
eorstu -> ouster,routes
epprsu -> uppers,supper
eprssu -> purses,supers
eprstu -> erupts,purest
epsstu -> upsets,setups
ersstw -> wrests,strews
ersttu -> utters,truest
erstuu -> uterus,suture
fhirst -> firths,shrift
fnostu -> founts,futons
gginor -> goring,gringo
ghilst -> lights,slight
ghinst -> things,nights
ghirst -> girths,rights
ghostu -> sought,toughs
giimnr -> miring,riming
giinrs -> rising,siring
giinrv -> riving,virgin
gilnop -> loping,poling
gilnos -> losing,soling
gilnpu -> plugin,puling
gilnru -> luring,ruling
gimnpu -> impugn,umping
ginnot -> noting,toning
ginopr -> poring,roping
ginors -> groins,signor
gnrstu -> grunts,strung
hilosw -> owlish,lowish
hrsttu -> thrust,truths
ilnstu -> insult,sunlit
ilopst -> pilots,pistol
imnost -> inmost,monist
innosu -> unions,unison
inoopt -> option,potion
inoprs -> prions,prison
inprst -> prints,sprint
inqstu -> quints,squint
iqrstu -> quirts,squirt
llorst -> stroll,trolls
loopss -> sloops,spools
loppsy -> polyps,sloppy
nooprt -> pronto,proton
noopss -> snoops,spoons
oorsst -> roosts,torsos
oprsst -> sports,strops
oprstu -> sprout,stupor
opttuu -> output,putout
orsttu -> trouts,tutors
rssttu -> struts,trusts
